   N  xxx ./srcs/sprites/xpm/brick1.xpm  eeee



SO   333 ./path_to_the_south_texture 222222222
     W   2     ./path_to_the_west_texture 222
   EA ./path_to_the_east_texture eee22

        F  x 230,184,106
    C 140,138,135

        1111111111111111111111111
        1000000000000000000000001
        1000000000000000000000001
        10000000000000000S0000001
111111111000000000000000000011111
10000000000000000000000000001
10000000000111111100000000001
100000000001     100000000001
10000000000111111100000000001
10000000000000000000000000001
10000000000000000000000000001
10000001110000011100000000111
10000001 1000001 100000000001
11111111111111111111111111111
11111111 1111111 111111111111
11111111111111111111111111111
11111111 1111111 111111111111
11111111111111111111111111111
