NO ./path_to_the_north_nexture
SO ./path_to_the_north_nexture
WE ./path_to_the_north_nexture
EA ./path_to_the_north_nexture

F 220,100,0
C 225,30,0

1111111111111111111
1000000010000000001
1000000010000000001
1000W00010000000000
1000000010000000001
1000000010000000001
1111111111111111111
