NO ./path_to_the_north_nexture
SO ./path_to_the_north_nexture
WE ./path_to_the_north_nexture
EA ./path_to_the_north_nexture

F 220,100,0
C 225,30,0

1111111
1000001111111111111
100000000011
1000000001111111
1W000000000000011111
1000000000000000001
1111111111111111111
