NO   ./path_to_the_north_texture
SO   ./path_to_the_south_texture
WE ./path_to_the_west_texture
EA ./path_to_the_east_texture

C 220,100,0
F  225,30,0

        1111111111111111111111111
        1000000000000000000000001
        1000000000000000000000001
        1000000000000000000000001
111111111000000000000000000011111
10000000000000000000000000001
10000000000111111100000000001
100000000001     100000000001
10000000000111111100000000001
10000000000000000000000000001
100000000000000000000000N0001
10000001110000011100000000111
10000001 1000001 100000000001
11111111 1111111 111111111111
