   N  ./srcs/sprites/cube3dtex/xpm/finestra.xpm
S   ./srcs/sprites/Walls/WallS.xpm
     W   ./srcs/sprites/cube3dtex/xpm/monitor2.xpm
EA ./srcs/sprites/cube3dtex/xpm/42window.xpm

        F   105,97,88
    C 232,176,107

        1111111111111111111111111              11111111111111111
        100000000000000000000000111111111111111110000000000000011111111111111111111111
        1000000000000000010000000P00000P0000P00000000000000000000000000000000000000001
        100000000000000000000000111111111111111100000000000000011111111111111P11111111
11111111100000000000000S000011111              111P1111111111111            101
10000000000111111100000000001                    1001                       101
100000000001     100000000001                    1001                       101
10000000000111111100000000001                    1001                       101
10000000000000000000000P00001                    1001                       101
10000000000000000000000000001111111111111111111111001                       101
1000000111000001P10000000010P0000000000000000000P00011                      101
10000001110000011100000000001111111111111111111111111                       101
10000000000000000000001000001                                               101
1111110000000000000000111000111111111111111111111111111111111111111111111111101
1111110000000000000000000000P00000000000000000000000000000000000000000000000P01
1000000000000000000001111111111111111111111111111111111111111111111111111111111
11111111111111111111111111111
