   N  ./srcs/sprites/cube3dtex/xpm/sprite42logo.xpm
S   ./srcs/sprites/cube3dtex/xpm/finestra.xpm
     W   ./srcs/sprites/cube3dtex/xpm/door4.xpm
EA ./srcs/sprites/cube3dtex/xpm/door1.xpm

        F   1,30,0
    C 0,0,255

        1111111111111111111111111
        1000000000000000000000001
        1000000000000000000000001
        10000000000000000N0000001
111111111000000000000000000011111
10000000000111111100000000001
100000000001     100000000001
10000000000111111100000000001
10000000000000000000000000001
10000000000000000000000000001
1000000111000001P100000000111
10000001110000011100000000001
1000P000000000000000001P00001
11111100000000000000001110001
11111100000000000000000000001
10000000000000000000011111111
11111111111111111111111111111
