   N  ./srcs/sprites/cube3dtex/xpm/finestra.xpm
S   ./srcs/sprites/Walls/WallS.xpm

                            W   ./srcs/sprites/cube3dtex/xpm/monitor2.xpm
EA ./srcs/sprites/cube3dtex/xpm/42window.xpm

F   237,206,138
C 186,178,162

        1111111111111111111111111              11111111111111111
        100000000000000000000000111111111111111110000000000000011111111111111111111111
        10000000000000000100000P0P00000P0000P00000000000000000000000000000000000000001
        100000000000000000000000111111111111111100000000000000011111111111111P11111111
111111111000000000000000000011111              111P1111111111111            101
10000000000111111100000000001                    1001                       101
100000000001     100000000001 1  1  1  1 1  1  1 1001                       101
10000000000111111100000000001                    1001                       101
10000000000000000000000000001                   11001                       101
10000000000000000000000000001111111111111111111111001                       101
1000000111000001P10000000010P0000000000000000000P00011                      101
10000001110000011100000000001111111111111111111111111                       101
10000000000000000000001000001                                               101
1111110000000000000000111000111111111111111111111111111111111111111111111111101
1111110000000000000000000000P00000000000000000000000000000000000000000000000P01
1111110000000000000000000000P00000000000000000000000000000000000000001000000P01
1111110000000000000000000000P00000000000000000000000000000000000000N00100000P01
1110000000000000000000000000000000000000000000000000000000000000000000000000001
1000000000000000000001111111111111111111111111111111111111111111111111111111111
111111111111111111111111111
